"filename", "language", "C++", "Markdown", "Go", "comment", "blank", "total"
"d:\BaiduSyncdisk\OCI\Code.go", "Go", 0, 0, -16, 0, -6, -22
"d:\BaiduSyncdisk\OCI\README.md", "Markdown", 0, 3, 0, 0, 3, 6
"d:\BaiduSyncdisk\OCI\execute\alltransports\alltransports.cpp", "C++", 21, 0, 0, 0, 4, 25
"d:\BaiduSyncdisk\OCI\execute\attributedstring\slice.cpp", "C++", 6, 0, 0, 0, 1, 7
"d:\BaiduSyncdisk\OCI\execute\auth\auth.cpp", "C++", 10, 0, 0, 5, 3, 18
"d:\BaiduSyncdisk\OCI\execute\capabilities\capabilities.cpp", "C++", 1, 0, 0, 0, 1, 2
"d:\BaiduSyncdisk\OCI\execute\cli\build.cpp", "C++", 1, 0, 0, 17, 2, 20
"d:\BaiduSyncdisk\OCI\execute\cli\common.cpp", "C++", 11, 0, 0, 93, 16, 120
"d:\BaiduSyncdisk\OCI\execute\cmd\build.cpp", "C++", -238, 0, 0, -75, -16, -329
"d:\BaiduSyncdisk\OCI\execute\cmd\config.cpp", "C++", -15, 0, 0, -23, -4, -42
"d:\BaiduSyncdisk\OCI\execute\cmd\images.cpp", "C++", -15, 0, 0, -21, -4, -40
"d:\BaiduSyncdisk\OCI\execute\cmd\info.cpp", "C++", -11, 0, 0, -19, -2, -32
"d:\BaiduSyncdisk\OCI\execute\cmd\inspect.cpp", "C++", -11, 0, 0, -19, -2, -32
"d:\BaiduSyncdisk\OCI\execute\cmd\login.cpp", "C++", -13, 0, 0, -21, -3, -37
"d:\BaiduSyncdisk\OCI\execute\cmd\logout.cpp", "C++", -13, 0, 0, -21, -3, -37
"d:\BaiduSyncdisk\OCI\execute\cmd\pull.cpp", "C++", -17, 0, 0, -21, -4, -42
"d:\BaiduSyncdisk\OCI\execute\cmd\push.cpp", "C++", -15, 0, 0, -21, -3, -39
"d:\BaiduSyncdisk\OCI\execute\cmd\rmi.cpp", "C++", -11, 0, 0, -19, -2, -32
"d:\BaiduSyncdisk\OCI\execute\cmd\root.cpp", "C++", -50, 0, 0, -17, -10, -77
"d:\BaiduSyncdisk\OCI\execute\cmd\tag.cpp", "C++", -12, 0, 0, -19, -2, -33
"d:\BaiduSyncdisk\OCI\execute\cmd\version.cpp", "C++", -13, 0, 0, -21, -3, -37
"d:\BaiduSyncdisk\OCI\execute\cobra\command.cpp", "C++", 0, 0, 0, 18, 0, 18
"d:\BaiduSyncdisk\OCI\execute\cobra\flag.cpp", "C++", -3, 0, 0, 46, -1, 42
"d:\BaiduSyncdisk\OCI\execute\config\config.cpp", "C++", 7, 0, 0, 8, 2, 17
"d:\BaiduSyncdisk\OCI\execute\define\build.cpp", "C++", 0, 0, 0, 19, 0, 19
"d:\BaiduSyncdisk\OCI\execute\define\define.cpp", "C++", 0, 0, 0, -10, -1, -11
"d:\BaiduSyncdisk\OCI\execute\define\pull.cpp", "C++", 0, 0, 0, -5, 0, -5
"d:\BaiduSyncdisk\OCI\execute\define\types.cpp", "C++", -2, 0, 0, 21, 1, 20
"d:\BaiduSyncdisk\OCI\execute\docker\reference.cpp", "C++", -29, 0, 0, 0, -1, -30
"d:\BaiduSyncdisk\OCI\execute\go\file.cpp", "C++", 32, 0, 0, 45, 4, 81
"d:\BaiduSyncdisk\OCI\execute\go\string.cpp", "C++", 35, 0, 0, 10, 2, 47
"d:\BaiduSyncdisk\OCI\execute\idtools\idtools.cpp", "C++", 7, 0, 0, 8, 3, 18
"d:\BaiduSyncdisk\OCI\execute\imagebuildah\build.cpp", "C++", 179, 0, 0, 17, 16, 212
"d:\BaiduSyncdisk\OCI\execute\imagebuildah\executor.cpp", "C++", 28, 0, 0, 2, 4, 34
"d:\BaiduSyncdisk\OCI\execute\imagebuildah\stage_executor.cpp", "C++", 1, 0, 0, 0, 1, 2
"d:\BaiduSyncdisk\OCI\execute\imagebuilder\builder.cpp", "C++", 30, 0, 0, 7, 5, 42
"d:\BaiduSyncdisk\OCI\execute\imagebuilder\evaluator.cpp", "C++", 13, 0, 0, 1, 2, 16
"d:\BaiduSyncdisk\OCI\execute\logrus\logger.cpp", "C++", 5, 0, 0, 0, 2, 7
"d:\BaiduSyncdisk\OCI\execute\logrus\logrus.cpp", "C++", 73, 0, 0, 0, 4, 77
"d:\BaiduSyncdisk\OCI\execute\main.cpp", "C++", -1, 0, 0, 12, -2, 9
"d:\BaiduSyncdisk\OCI\execute\main\build.cpp", "C++", 238, 0, 0, 97, 19, 354
"d:\BaiduSyncdisk\OCI\execute\main\config.cpp", "C++", 15, 0, 0, 36, 4, 55
"d:\BaiduSyncdisk\OCI\execute\main\images.cpp", "C++", 15, 0, 0, 21, 4, 40
"d:\BaiduSyncdisk\OCI\execute\main\info.cpp", "C++", 11, 0, 0, 19, 2, 32
"d:\BaiduSyncdisk\OCI\execute\main\inspect.cpp", "C++", 11, 0, 0, 19, 2, 32
"d:\BaiduSyncdisk\OCI\execute\main\login.cpp", "C++", 13, 0, 0, 21, 3, 37
"d:\BaiduSyncdisk\OCI\execute\main\logout.cpp", "C++", 13, 0, 0, 21, 3, 37
"d:\BaiduSyncdisk\OCI\execute\main\pull.cpp", "C++", 17, 0, 0, 21, 4, 42
"d:\BaiduSyncdisk\OCI\execute\main\push.cpp", "C++", 15, 0, 0, 21, 3, 39
"d:\BaiduSyncdisk\OCI\execute\main\rmi.cpp", "C++", 11, 0, 0, 19, 2, 32
"d:\BaiduSyncdisk\OCI\execute\main\root.cpp", "C++", 50, 0, 0, 17, 10, 77
"d:\BaiduSyncdisk\OCI\execute\main\tag.cpp", "C++", 12, 0, 0, 19, 2, 33
"d:\BaiduSyncdisk\OCI\execute\main\version.cpp", "C++", 13, 0, 0, 21, 3, 37
"d:\BaiduSyncdisk\OCI\execute\multierror\group.cpp", "C++", 18, 0, 0, 32, 3, 53
"d:\BaiduSyncdisk\OCI\execute\parse\buildkitparser.cpp", "C++", 56, 0, 0, 3, 10, 69
"d:\BaiduSyncdisk\OCI\execute\parse\dockerfileparse.cpp", "C++", 332, 0, 0, 45, 49, 426
"d:\BaiduSyncdisk\OCI\execute\parse\line_parsers.cpp", "C++", 385, 0, 0, 33, 51, 469
"d:\BaiduSyncdisk\OCI\execute\parse\parse.cpp", "C++", 373, 0, 0, 128, 66, 567
"d:\BaiduSyncdisk\OCI\execute\parse\split_command.cpp", "C++", 104, 0, 0, 5, 10, 119
"d:\BaiduSyncdisk\OCI\execute\pflag\value.cpp", "C++", 0, 0, 0, 0, 1, 1
"d:\BaiduSyncdisk\OCI\execute\pkg\auth\auth.cpp", "C++", -10, 0, 0, 0, -3, -13
"d:\BaiduSyncdisk\OCI\execute\pkg\idtools\idtools.cpp", "C++", -7, 0, 0, 0, -2, -9
"d:\BaiduSyncdisk\OCI\execute\pkg\parse\parse.cpp", "C++", -308, 0, 0, -70, -57, -435
"d:\BaiduSyncdisk\OCI\execute\pkg\util\util.cpp", "C++", -88, 0, 0, 0, -7, -95
"d:\BaiduSyncdisk\OCI\execute\reference\reference.cpp", "C++", 29, 0, 0, 0, 1, 30
"d:\BaiduSyncdisk\OCI\execute\regexp\regexp.cpp", "C++", 243, 0, 0, 26, 52, 321
"d:\BaiduSyncdisk\OCI\execute\semaphore\semaphore.cpp", "C++", 4, 0, 0, 0, 1, 5
"d:\BaiduSyncdisk\OCI\execute\shell\lex.cpp", "C++", 306, 0, 0, 14, 32, 352
"d:\BaiduSyncdisk\OCI\execute\storage\utils.cpp", "C++", -64, 0, 0, -67, -5, -136
"d:\BaiduSyncdisk\OCI\execute\transports\transports.cpp", "C++", 30, 0, 0, 0, 1, 31
"d:\BaiduSyncdisk\OCI\execute\types\options.cpp", "C++", 141, 0, 0, 117, 17, 275
"d:\BaiduSyncdisk\OCI\execute\util\util.cpp", "C++", 76, 0, 0, 24, 7, 107
"d:\BaiduSyncdisk\OCI\execute\v1\descriptor.cpp", "C++", 7, 0, 0, 0, 1, 8
"d:\BaiduSyncdisk\OCI\include\alltransports\alltransports.h", "C++", 10, 0, 0, 0, 4, 14
"d:\BaiduSyncdisk\OCI\include\attributedstring\slice.h", "C++", 13, 0, 0, 0, 1, 14
"d:\BaiduSyncdisk\OCI\include\auth\auth.h", "C++", 7, 0, 0, 0, 2, 9
"d:\BaiduSyncdisk\OCI\include\buildah\buildah.h", "C++", 50, 0, 0, 39, 38, 127
"d:\BaiduSyncdisk\OCI\include\buildah\digest.h", "C++", 25, 0, 0, 5, 7, 37
"d:\BaiduSyncdisk\OCI\include\bytes\buffer.h", "C++", 20, 0, 0, 3, 4, 27
"d:\BaiduSyncdisk\OCI\include\capabilities\capabilities.h", "C++", 3, 0, 0, 0, 4, 7
"d:\BaiduSyncdisk\OCI\include\cli\build.h", "C++", 0, 0, 0, 108, 2, 110
"d:\BaiduSyncdisk\OCI\include\cli\common.h", "C++", 5, 0, 0, 10, 2, 17
"d:\BaiduSyncdisk\OCI\include\cmd\build.h", "C++", -27, 0, 0, -15, -2, -44
"d:\BaiduSyncdisk\OCI\include\cmd\config.h", "C++", -23, 0, 0, -15, -1, -39
"d:\BaiduSyncdisk\OCI\include\cmd\images.h", "C++", -15, 0, 0, -16, -1, -32
"d:\BaiduSyncdisk\OCI\include\cmd\info.h", "C++", -11, 0, 0, -10, -1, -22
"d:\BaiduSyncdisk\OCI\include\cmd\inspect.h", "C++", -11, 0, 0, -10, -1, -22
"d:\BaiduSyncdisk\OCI\include\cmd\login.h", "C++", -17, 0, 0, -15, -1, -33
"d:\BaiduSyncdisk\OCI\include\cmd\logout.h", "C++", -15, 0, 0, -16, -3, -34
"d:\BaiduSyncdisk\OCI\include\cmd\pull.h", "C++", -15, 0, 0, -15, -1, -31
"d:\BaiduSyncdisk\OCI\include\cmd\push.h", "C++", -15, 0, 0, -15, -1, -31
"d:\BaiduSyncdisk\OCI\include\cmd\rmi.h", "C++", -11, 0, 0, -10, -1, -22
"d:\BaiduSyncdisk\OCI\include\cmd\root.h", "C++", -22, 0, 0, -22, -4, -48
"d:\BaiduSyncdisk\OCI\include\cmd\tag.h", "C++", -11, 0, 0, -10, -1, -22
"d:\BaiduSyncdisk\OCI\include\cmd\version.h", "C++", -15, 0, 0, -15, -1, -31
"d:\BaiduSyncdisk\OCI\include\cobra\error.h", "C++", 4, 0, 0, 0, 0, 4
"d:\BaiduSyncdisk\OCI\include\config\config.h", "C++", 6, 0, 0, 0, 5, 11
"d:\BaiduSyncdisk\OCI\include\define\build.h", "C++", -3, 0, 0, 2, 0, -1
"d:\BaiduSyncdisk\OCI\include\define\specs.h", "C++", -24, 0, 0, -8, -4, -36
"d:\BaiduSyncdisk\OCI\include\define\types.h", "C++", 10, 0, 0, 0, 0, 10
"d:\BaiduSyncdisk\OCI\include\define\types_unix.h", "C++", 15, 0, 0, 0, 1, 16
"d:\BaiduSyncdisk\OCI\include\devices\devices.h", "C++", 30, 0, 0, 11, 10, 51
"d:\BaiduSyncdisk\OCI\include\digest\digest.h", "C++", 13, 0, 0, 0, 3, 16
"d:\BaiduSyncdisk\OCI\include\docker\container.h", "C++", 58, 0, 0, 11, 6, 75
"d:\BaiduSyncdisk\OCI\include\docker\reference.h", "C++", -46, 0, 0, -1, -3, -50
"d:\BaiduSyncdisk\OCI\include\github\digest.h", "C++", -11, 0, 0, 0, -4, -15
"d:\BaiduSyncdisk\OCI\include\go\file.h", "C++", 14, 0, 0, 0, 6, 20
"d:\BaiduSyncdisk\OCI\include\go\string.h", "C++", 13, 0, 0, 10, 1, 24
"d:\BaiduSyncdisk\OCI\include\graphdriver\driver.h", "C++", 22, 0, 0, 3, 4, 29
"d:\BaiduSyncdisk\OCI\include\idtools\idtools.h", "C++", 28, 0, 0, 0, 5, 33
"d:\BaiduSyncdisk\OCI\include\imagebuildah\build.h", "C++", 2, 0, 0, 0, 0, 2
"d:\BaiduSyncdisk\OCI\include\imagebuildah\executor.h", "C++", 135, 0, 0, 3, 5, 143
"d:\BaiduSyncdisk\OCI\include\imagebuildah\stage_executor.h", "C++", 40, 0, 0, 10, 4, 54
"d:\BaiduSyncdisk\OCI\include\imagebuilder\builder.h", "C++", 76, 0, 0, 3, 6, 85
"d:\BaiduSyncdisk\OCI\include\imagebuilder\evaluator.h", "C++", 13, 0, 0, 0, 2, 15
"d:\BaiduSyncdisk\OCI\include\internal\types.h", "C++", 21, 0, 0, 2, 3, 26
"d:\BaiduSyncdisk\OCI\include\logrus\bufferpool.h", "C++", 14, 0, 0, 1, 3, 18
"d:\BaiduSyncdisk\OCI\include\logrus\formatter.h", "C++", 13, 0, 0, 1, 2, 16
"d:\BaiduSyncdisk\OCI\include\logrus\hooks.h", "C++", 15, 0, 0, 16, 4, 35
"d:\BaiduSyncdisk\OCI\include\logrus\logger.h", "C++", 32, 0, 0, 61, 16, 109
"d:\BaiduSyncdisk\OCI\include\logrus\logrus.h", "C++", 26, 0, 0, 9, 2, 37
"d:\BaiduSyncdisk\OCI\include\main\build.h", "C++", 27, 0, 0, 15, 2, 44
"d:\BaiduSyncdisk\OCI\include\main\config.h", "C++", 23, 0, 0, 15, 1, 39
"d:\BaiduSyncdisk\OCI\include\main\images.h", "C++", 15, 0, 0, 16, 1, 32
"d:\BaiduSyncdisk\OCI\include\main\info.h", "C++", 11, 0, 0, 10, 1, 22
"d:\BaiduSyncdisk\OCI\include\main\inspect.h", "C++", 11, 0, 0, 10, 1, 22
"d:\BaiduSyncdisk\OCI\include\main\login.h", "C++", 17, 0, 0, 15, 1, 33
"d:\BaiduSyncdisk\OCI\include\main\logout.h", "C++", 15, 0, 0, 16, 3, 34
"d:\BaiduSyncdisk\OCI\include\main\pull.h", "C++", 15, 0, 0, 15, 1, 31
"d:\BaiduSyncdisk\OCI\include\main\push.h", "C++", 15, 0, 0, 15, 1, 31
"d:\BaiduSyncdisk\OCI\include\main\rmi.h", "C++", 11, 0, 0, 10, 1, 22
"d:\BaiduSyncdisk\OCI\include\main\root.h", "C++", 22, 0, 0, 22, 4, 48
"d:\BaiduSyncdisk\OCI\include\main\tag.h", "C++", 11, 0, 0, 10, 1, 22
"d:\BaiduSyncdisk\OCI\include\main\version.h", "C++", 15, 0, 0, 15, 1, 31
"d:\BaiduSyncdisk\OCI\include\multierror\group.h", "C++", 21, 0, 0, 0, 3, 24
"d:\BaiduSyncdisk\OCI\include\parse\buildkitparser.h", "C++", 16, 0, 0, 0, 1, 17
"d:\BaiduSyncdisk\OCI\include\parse\dockerfileparse.h", "C++", 61, 0, 0, 1, 6, 68
"d:\BaiduSyncdisk\OCI\include\parse\line_parsers.h", "C++", 23, 0, 0, 0, 1, 24
"d:\BaiduSyncdisk\OCI\include\parse\parse.h", "C++", 24, 0, 0, 1, 4, 29
"d:\BaiduSyncdisk\OCI\include\parse\split_command.h", "C++", 11, 0, 0, 0, 2, 13
"d:\BaiduSyncdisk\OCI\include\pkg\auth\auth.h", "C++", -7, 0, 0, 0, -2, -9
"d:\BaiduSyncdisk\OCI\include\pkg\idtools\idtools.h", "C++", -28, 0, 0, 0, -5, -33
"d:\BaiduSyncdisk\OCI\include\pkg\internal\types.h", "C++", -21, 0, 0, -2, -3, -26
"d:\BaiduSyncdisk\OCI\include\pkg\parse\parse.h", "C++", -21, 0, 0, -1, -2, -24
"d:\BaiduSyncdisk\OCI\include\pkg\util\util.h", "C++", -14, 0, 0, 0, -1, -15
"d:\BaiduSyncdisk\OCI\include\reference\reference.h", "C++", 46, 0, 0, 1, 3, 50
"d:\BaiduSyncdisk\OCI\include\regexp\regexp.h", "C++", 45, 0, 0, 0, 1, 46
"d:\BaiduSyncdisk\OCI\include\runtime_spec\config.h", "C++", 7, 0, 0, 0, 4, 11
"d:\BaiduSyncdisk\OCI\include\semaphore\semaphore.h", "C++", 17, 0, 0, 0, 3, 20
"d:\BaiduSyncdisk\OCI\include\shell\lex.h", "C++", 56, 0, 0, 2, 10, 68
"d:\BaiduSyncdisk\OCI\include\specs\specs.h", "C++", 34, 0, 0, 25, 4, 63
"d:\BaiduSyncdisk\OCI\include\sshagent\sshagent.h", "C++", 14, 0, 0, 1, 3, 18
"d:\BaiduSyncdisk\OCI\include\storage\driver\driver.h", "C++", -22, 0, 0, -3, -4, -29
"d:\BaiduSyncdisk\OCI\include\storage\utils.h", "C++", -33, 0, 0, -17, -4, -54
"d:\BaiduSyncdisk\OCI\include\sync\cond.h", "C++", 13, 0, 0, 4, 3, 20
"d:\BaiduSyncdisk\OCI\include\sync\mutex.h", "C++", 14, 0, 0, 16, 5, 35
"d:\BaiduSyncdisk\OCI\include\sync\pool.h", "C++", 21, 0, 0, 4, 8, 33
"d:\BaiduSyncdisk\OCI\include\system\lcow_unix.h", "C++", 16, 0, 0, 4, 1, 21
"d:\BaiduSyncdisk\OCI\include\transports\transports.h", "C++", 19, 0, 0, 0, 4, 23
"d:\BaiduSyncdisk\OCI\include\types\network.h", "C++", 10, 0, 0, 0, 3, 13
"d:\BaiduSyncdisk\OCI\include\types\options.h", "C++", 44, 0, 0, 35, 2, 81
"d:\BaiduSyncdisk\OCI\include\types\types.h", "C++", 18, 0, 0, 20, 12, 50
"d:\BaiduSyncdisk\OCI\include\util\util.h", "C++", 16, 0, 0, 0, 7, 23
"d:\BaiduSyncdisk\OCI\include\v1\config.h", "C++", 46, 0, 0, 24, 15, 85
"d:\BaiduSyncdisk\OCI\include\v1\descriptor.h", "C++", 36, 0, 0, 0, 3, 39
"d:\BaiduSyncdisk\OCI\include\v1\mediatype.h", "C++", 15, 0, 0, 11, 11, 37
"d:\BaiduSyncdisk\OCI\test.cpp", "C++", -4, 0, 0, -2, 2, -4
"Total", "-", 3194, 3, -16, 1062, 537, 4780