"filename", "language", "C++", "Markdown", "Doxyfile", "comment", "blank", "total"
"d:\BaiduSyncdisk\OCI\Doxyfile", "Doxyfile", 0, 0, 358, 1929, 616, 2903
"d:\BaiduSyncdisk\OCI\README.md", "Markdown", 0, 2, 0, 0, 1, 3
"d:\BaiduSyncdisk\OCI\execute\Config_Json.cpp", "C++", 8, 0, 0, 10, 1, 19
"d:\BaiduSyncdisk\OCI\execute\args.cpp", "C++", 10, 0, 0, 7, 0, 17
"d:\BaiduSyncdisk\OCI\execute\build.cpp", "C++", 185, 0, 0, 67, 16, 268
"d:\BaiduSyncdisk\OCI\execute\command.cpp", "C++", 530, 0, 0, 295, 24, 849
"d:\BaiduSyncdisk\OCI\execute\common.cpp", "C++", 26, 0, 0, 24, 4, 54
"d:\BaiduSyncdisk\OCI\execute\config.cpp", "C++", 15, 0, 0, 23, 4, 42
"d:\BaiduSyncdisk\OCI\execute\error.cpp", "C++", 1, 0, 0, 0, 2, 3
"d:\BaiduSyncdisk\OCI\execute\flag.cpp", "C++", 278, 0, 0, 278, 12, 568
"d:\BaiduSyncdisk\OCI\execute\images.cpp", "C++", 15, 0, 0, 21, 4, 40
"d:\BaiduSyncdisk\OCI\execute\info.cpp", "C++", 11, 0, 0, 19, 2, 32
"d:\BaiduSyncdisk\OCI\execute\inspect.cpp", "C++", 11, 0, 0, 19, 2, 32
"d:\BaiduSyncdisk\OCI\execute\login.cpp", "C++", 13, 0, 0, 21, 3, 37
"d:\BaiduSyncdisk\OCI\execute\logout.cpp", "C++", 13, 0, 0, 21, 3, 37
"d:\BaiduSyncdisk\OCI\execute\options.cpp", "C++", 67, 0, 0, 74, 4, 145
"d:\BaiduSyncdisk\OCI\execute\pull.cpp", "C++", 17, 0, 0, 21, 3, 41
"d:\BaiduSyncdisk\OCI\execute\push.cpp", "C++", 15, 0, 0, 21, 3, 39
"d:\BaiduSyncdisk\OCI\execute\rmi.cpp", "C++", 11, 0, 0, 19, 2, 32
"d:\BaiduSyncdisk\OCI\execute\root.cpp", "C++", 48, 0, 0, 17, 10, 75
"d:\BaiduSyncdisk\OCI\execute\tag.cpp", "C++", 12, 0, 0, 19, 2, 33
"d:\BaiduSyncdisk\OCI\execute\value.cpp", "C++", 165, 0, 0, 202, 3, 370
"d:\BaiduSyncdisk\OCI\execute\version.cpp", "C++", 13, 0, 0, 21, 3, 37
"d:\BaiduSyncdisk\OCI\include\Config_Json.h", "C++", 29, 0, 0, 14, 18, 61
"d:\BaiduSyncdisk\OCI\include\args.h", "C++", 13, 0, 0, 11, 2, 26
"d:\BaiduSyncdisk\OCI\include\build.h", "C++", 200, 0, 0, 184, 4, 388
"d:\BaiduSyncdisk\OCI\include\command.h", "C++", 93, 0, 0, 48, 7, 148
"d:\BaiduSyncdisk\OCI\include\common.h", "C++", 10, 0, 0, 10, 1, 21
"d:\BaiduSyncdisk\OCI\include\config.h", "C++", 23, 0, 0, 15, 1, 39
"d:\BaiduSyncdisk\OCI\include\context.h", "C++", 9, 0, 0, 2, 5, 16
"d:\BaiduSyncdisk\OCI\include\creat.h", "C++", 7, 0, 0, 14, 797, 818
"d:\BaiduSyncdisk\OCI\include\error.h", "C++", 20, 0, 0, 19, 5, 44
"d:\BaiduSyncdisk\OCI\include\flag.h", "C++", 76, 0, 0, 27, 4, 107
"d:\BaiduSyncdisk\OCI\include\images.h", "C++", 15, 0, 0, 16, 1, 32
"d:\BaiduSyncdisk\OCI\include\info.h", "C++", 11, 0, 0, 10, 1, 22
"d:\BaiduSyncdisk\OCI\include\inspect.h", "C++", 11, 0, 0, 10, 1, 22
"d:\BaiduSyncdisk\OCI\include\login.h", "C++", 17, 0, 0, 15, 1, 33
"d:\BaiduSyncdisk\OCI\include\logout.h", "C++", 15, 0, 0, 16, 3, 34
"d:\BaiduSyncdisk\OCI\include\options.h", "C++", 34, 0, 0, 16, 4, 54
"d:\BaiduSyncdisk\OCI\include\pull.h", "C++", 17, 0, 0, 15, 1, 33
"d:\BaiduSyncdisk\OCI\include\push.h", "C++", 15, 0, 0, 15, 1, 31
"d:\BaiduSyncdisk\OCI\include\rmi.h", "C++", 11, 0, 0, 10, 1, 22
"d:\BaiduSyncdisk\OCI\include\root.h", "C++", 20, 0, 0, 22, 4, 46
"d:\BaiduSyncdisk\OCI\include\tag.h", "C++", 11, 0, 0, 10, 1, 22
"d:\BaiduSyncdisk\OCI\include\value.h", "C++", 88, 0, 0, 42, 2, 132
"d:\BaiduSyncdisk\OCI\include\version.h", "C++", 15, 0, 0, 15, 1, 31
"d:\BaiduSyncdisk\OCI\main.cpp", "C++", 26, 0, 0, 26, 6, 58
"d:\BaiduSyncdisk\OCI\test.cpp", "C++", 30, 0, 0, 2, 4, 36
"Total", "-", 2280, 2, 358, 3712, 1600, 7952