"filename", "language", "Docker", "Markdown", "C++", "Shell Script", "comment", "blank", "total"
"e:\BaiduSyncdisk\OCI\Dockerfile", "Docker", -2, 0, 0, 0, 15, 3, 16
"e:\BaiduSyncdisk\OCI\README.md", "Markdown", 0, 2, 0, 0, 0, 0, 2
"e:\BaiduSyncdisk\OCI\app\my_script.sh", "Shell Script", 0, 0, 0, 1, 2, 2, 5
"e:\BaiduSyncdisk\OCI\execute\blobcache\blobcache.cpp", "C++", 0, 0, 4, 0, 0, 3, 7
"e:\BaiduSyncdisk\OCI\execute\buildah\buildah.cpp", "C++", 0, 0, 7, 0, 0, 0, 7
"e:\BaiduSyncdisk\OCI\execute\buildah\new.cpp", "C++", 0, 0, 43, 0, 2, 1, 46
"e:\BaiduSyncdisk\OCI\execute\buildah\push.cpp", "C++", 0, 0, 16, 0, 0, 1, 17
"e:\BaiduSyncdisk\OCI\execute\cli\build.cpp", "C++", 0, 0, 0, 0, 1, 0, 1
"e:\BaiduSyncdisk\OCI\execute\cli\common.cpp", "C++", 0, 0, 7, 0, 0, -1, 6
"e:\BaiduSyncdisk\OCI\execute\config\config.cpp", "C++", 0, 0, 1, 0, 0, 0, 1
"e:\BaiduSyncdisk\OCI\execute\config\default_linux.cpp", "C++", 0, 0, -1, 0, 2, 0, 1
"e:\BaiduSyncdisk\OCI\execute\config\defaut.cpp", "C++", 0, 0, 1, 0, -2, 0, -1
"e:\BaiduSyncdisk\OCI\execute\config\new.cpp", "C++", 0, 0, 6, 0, 3, -2, 7
"e:\BaiduSyncdisk\OCI\execute\define\pull.cpp", "C++", 0, 0, 13, 0, 1, 1, 15
"e:\BaiduSyncdisk\OCI\execute\docker\docker_transport.cpp", "C++", 0, 0, 54, 0, 2, 5, 61
"e:\BaiduSyncdisk\OCI\execute\go\string.cpp", "C++", 0, 0, 6, 0, 2, 0, 8
"e:\BaiduSyncdisk\OCI\execute\graphdriver\driver.cpp", "C++", 0, 0, 0, 0, 2, 1, 3
"e:\BaiduSyncdisk\OCI\execute\imagebuildah\build.cpp", "C++", 0, 0, 3, 0, 1, 0, 4
"e:\BaiduSyncdisk\OCI\execute\imagebuildah\executor.cpp", "C++", 0, 0, 5, 0, 1, -2, 4
"e:\BaiduSyncdisk\OCI\execute\imagebuildah\stage_executor.cpp", "C++", 0, 0, 69, 0, 3, 3, 75
"e:\BaiduSyncdisk\OCI\execute\imagebuilder\builder.cpp", "C++", 0, 0, -6, 0, 22, 0, 16
"e:\BaiduSyncdisk\OCI\execute\init\init_global.cpp", "C++", 0, 0, 30, 0, 0, -5, 25
"e:\BaiduSyncdisk\OCI\execute\libimage\pull.cpp", "C++", 0, 0, 1, 0, 0, 2, 3
"e:\BaiduSyncdisk\OCI\execute\libimage\runtime.cpp", "C++", 0, 0, 27, 0, 0, 4, 31
"e:\BaiduSyncdisk\OCI\execute\lockfile\lastwrite.cpp", "C++", 0, 0, 19, 0, 7, 6, 32
"e:\BaiduSyncdisk\OCI\execute\lockfile\lockfile.cpp", "C++", 0, 0, -4, 0, 7, -5, -2
"e:\BaiduSyncdisk\OCI\execute\logrus\entry.cpp", "C++", 0, 0, -2, 0, 5, 0, 3
"e:\BaiduSyncdisk\OCI\execute\main\build.cpp", "C++", 0, 0, 9, 0, -7, 0, 2
"e:\BaiduSyncdisk\OCI\execute\parse\dockerfileparse.cpp", "C++", 0, 0, -3, 0, -9, -2, -14
"e:\BaiduSyncdisk\OCI\execute\parse\parse.cpp", "C++", 0, 0, 10, 0, 1, -2, 9
"e:\BaiduSyncdisk\OCI\execute\parse\split_command.cpp", "C++", 0, 0, -1, 0, 1, 0, 0
"e:\BaiduSyncdisk\OCI\execute\pflag\value.cpp", "C++", 0, 0, 0, 0, 1, 0, 1
"e:\BaiduSyncdisk\OCI\execute\reference\normalize.cpp", "C++", 0, 0, 48, 0, 13, 13, 74
"e:\BaiduSyncdisk\OCI\execute\reference\reference.cpp", "C++", 0, 0, 38, 0, 6, 0, 44
"e:\BaiduSyncdisk\OCI\execute\reference\regexp.cpp", "C++", 0, 0, 0, 0, 0, 1, 1
"e:\BaiduSyncdisk\OCI\execute\regexp\regexp.cpp", "C++", 0, 0, 5, 0, 10, 2, 17
"e:\BaiduSyncdisk\OCI\execute\storage\storage.cpp", "C++", 0, 0, 0, 0, 8, -1, 7
"e:\BaiduSyncdisk\OCI\execute\toml\decode.cpp", "C++", 0, 0, 1, 0, 0, 1, 2
"e:\BaiduSyncdisk\OCI\execute\transports\transports.cpp", "C++", 0, 0, -1, 0, 1, 0, 0
"e:\BaiduSyncdisk\OCI\execute\types\options.cpp", "C++", 0, 0, -3, 0, 33, 2, 32
"e:\BaiduSyncdisk\OCI\include\blobcache\blobcache.h", "C++", 0, 0, 15, 0, 0, 4, 19
"e:\BaiduSyncdisk\OCI\include\buildah\buildah.h", "C++", 0, 0, 71, 0, 63, 0, 134
"e:\BaiduSyncdisk\OCI\include\buildah\new.h", "C++", 0, 0, 7, 0, 0, 4, 11
"e:\BaiduSyncdisk\OCI\include\buildah\push.h", "C++", 0, 0, 9, 0, 0, 3, 12
"e:\BaiduSyncdisk\OCI\include\bytes\buffer.h", "C++", 0, 0, 2, 0, 1, 0, 3
"e:\BaiduSyncdisk\OCI\include\config\new.h", "C++", 0, 0, 2, 0, -2, 0, 0
"e:\BaiduSyncdisk\OCI\include\define\pull.h", "C++", 0, 0, 2, 0, 0, -1, 1
"e:\BaiduSyncdisk\OCI\include\docker\docker_transport.h", "C++", 0, 0, 22, 0, 1, 5, 28
"e:\BaiduSyncdisk\OCI\include\go\string.h", "C++", 0, 0, 1, 0, 0, 0, 1
"e:\BaiduSyncdisk\OCI\include\graphdriver\driver.h", "C++", 0, 0, 5, 0, 1, 1, 7
"e:\BaiduSyncdisk\OCI\include\imagebuildah\executor.h", "C++", 0, 0, 3, 0, -2, 0, 1
"e:\BaiduSyncdisk\OCI\include\imagebuildah\stage_executor.h", "C++", 0, 0, 5, 0, 0, 0, 5
"e:\BaiduSyncdisk\OCI\include\imagebuilder\builder.h", "C++", 0, 0, 3, 0, 0, 0, 3
"e:\BaiduSyncdisk\OCI\include\init\init_global.h", "C++", 0, 0, 6, 0, 0, -1, 5
"e:\BaiduSyncdisk\OCI\include\libimage\copier.h", "C++", 0, 0, 50, 0, 43, 44, 137
"e:\BaiduSyncdisk\OCI\include\libimage\events.h", "C++", 0, 0, 31, 0, 17, 2, 50
"e:\BaiduSyncdisk\OCI\include\libimage\image.h", "C++", 0, 0, 26, 0, 16, 22, 64
"e:\BaiduSyncdisk\OCI\include\libimage\manifest.h", "C++", 0, 0, 11, 0, 0, 2, 13
"e:\BaiduSyncdisk\OCI\include\libimage\pull.h", "C++", 0, 0, 7, 0, 0, 1, 8
"e:\BaiduSyncdisk\OCI\include\libimage\runtime.h", "C++", 0, 0, 19, 0, 4, 4, 27
"e:\BaiduSyncdisk\OCI\include\lockfile\lastwrite.h", "C++", 0, 0, 14, 0, 0, -2, 12
"e:\BaiduSyncdisk\OCI\include\lockfile\lockfile.h", "C++", 0, 0, 1, 0, 0, 0, 1
"e:\BaiduSyncdisk\OCI\include\parse\dockerfileparse.h", "C++", 0, 0, 2, 0, 0, 0, 2
"e:\BaiduSyncdisk\OCI\include\reference\normalize.h", "C++", 0, 0, 9, 0, 0, 3, 12
"e:\BaiduSyncdisk\OCI\include\reference\reference.h", "C++", 0, 0, 40, 0, 2, 2, 44
"e:\BaiduSyncdisk\OCI\include\reference\regexp.h", "C++", 0, 0, 13, 0, 0, 3, 16
"e:\BaiduSyncdisk\OCI\include\signer\signer.h", "C++", 0, 0, 8, 0, 0, -1, 7
"e:\BaiduSyncdisk\OCI\include\storage\storage.h", "C++", 0, 0, 1, 0, 0, -1, 0
"e:\BaiduSyncdisk\OCI\include\toml\decode.h", "C++", 0, 0, 3, 0, 0, 4, 7
"e:\BaiduSyncdisk\OCI\include\transports\transports.h", "C++", 0, 0, 2, 0, 0, -1, 1
"e:\BaiduSyncdisk\OCI\include\types\options.h", "C++", 0, 0, 0, 0, 1, 0, 1
"e:\BaiduSyncdisk\OCI\include\types\types.h", "C++", 0, 0, 31, 0, 17, 15, 63
"e:\BaiduSyncdisk\OCI\test.cpp", "C++", 0, 0, -4, 0, 13, 8, 17
"Total", "-", -2, 2, 819, 1, 309, 151, 1280